BBBBBBBBBBBBBBBOBBB
B        B        B
B BB BBB B BBB BB B
B                 B
B BB B BBBBB B BB B
B    B   B   B    B
BBBB BBB B BBB BBBB
BBBB B___b___B BBBB
BBBB B_BB_BB_B BBBB
O     _B___B_     O
BBBB B_BBBBB_B BBBB
BBBB B_______B BBBB
BBBB B BBBBB B BBBB
B        B        B
B BB BBB B BBB BB B
B  B     P     B  B
BB B B BBBBB B B BB
B    B   B   B    B
B BBBBBB B BBBBBB B
B                 B
BBBBBOBBBBBBBBBBBBB