BBBBBBBBBBBBBBBOBBB
B        B     P  B
B BB BBB B BBB BB B
B                 B
B BB B BBBBB B BB B
B    B       B    B
BBBB BBB   BBB BBBB
BBB B B      B BBBB
BBBB B B   B B BBBB
O      B   B      O
BBBB B BBBBB B BBBB
BBBB B       B BBBB
BBBB B BBBBB B BBBB
B        B        B
B BB BBB B BBB BB B
B  B           B  B
BB B B BBBBB B B BB
B    B   B   B    B
B BBBBBB B BBBBBB B
B                 B
BBBBBOBBBBBBBBBBBBB